NO   ./path
WE  ./path
SO  ./path
 EA    ./path

F 255,255,255
C 255,255,255
  
    EA    ./path
 
1111111111111111111111111111
  1000000000000000000000000001
1000000000000000000000000001
 1000000000000000000000000001
1000000000000000000000000001
1000000000000000000000000001
1000000000000000000000000001
10000000000000000000000000N1
1111111111111111111111111111
