NO ./images/collect.png
WE ./images/player.png
SO ./images/exit.png
EA ./images/tile1.png

C 135,206,250
F 34,139,34

 
111111111111111
1 10000N0000001
111000111101111
100000000000001
111111111111111