NO   ./path
  WE  ./path   
  C   17 , 255 , 15
SO ./path  
 EA  ./path 

 F    15 , 15  , 255



1111111
100N111
1111111
