NO ./images/collect.png
WE ./images/player.png
SO ./images/exit.png
EA ./images/tile1.png

C 135,206,250
F 34,139,34

 
111111111111111
1 10000N0000001
1110001111011111
100000000000000111
1111111111111111