NO ./images/collect.png
WE ./path
SO ./path
EA ./path

C 135,206,250
F 34,139,34

11111
10N001
11111