NO   ./path
  WE  ./path   
  C   17 , 255 , 15
SO ./path  
 EA  ./path 

 F    15 , 15  , 255



1111111111111111111111111111
  1000000000000000000000000001
1000000000000000000000000001
 1000000000000000000000000001
1000000000000000000000000001
1000000000000000000000000001
1   1000000000000000000000000001
10000000000000000000000000000N01
1111111111111111111111111111