NO   ./path
  WE  ./path   
SO ./path  
 EA  ./path 

 F    15 , 15  , 255
  C   17 , 255 , 15


1111111111111111111111111111
  1000000000000000000000000001
1000000000000000000000000001
 1000000000000000000000000001
1000000000000000000000000001
1000000000000000000000000001
    1000000000000000000000000001
10000000000000000000000000N1
1111111111111111111111111111