NO ./images/collect.png
WE ./images/player.png
SO ./images/exit.png
EA ./images/tile1.png

C 135,206,250
F 34,139,34

11111111111111
10000000000011
101E1000000011
100000000000011
101110000000011
10000000000011
10000001111111
100110010000001
100000000000111
111111111111111
