NO ./images/collect.png
WE ./path
SO ./path
EA ./path

C 135,206,250
F 34,139,34

11111111111  
10N00000100
11111111111