NO ./path
WE ./path
SO ./path
EA ./path

C 135,206,250
F 34,139,34

1111111
100N111
1111111