NO ./images/collect.png
WE ./images/player.png
SO ./images/exit.png
EA ./images/tile1.png

C 135,206,250
F 34,139,34



1111111111111111111
1000000000000000001
1011111000000001101
1010000000000000101
1010111100110000101
1010100000000100101
1010100011000100101
1010101000010100101
10101010S0010100101
1010100011001100101
1010000000000000101
1011110011001111101
1000000000000000001
1111111111111111111








